chindes->kindes
christenhait->kristenhait
chinden->kinden
chunden->kunden
chnecht->knecht
chirchen->kirchen
chaiser->kaiser
choͤmen->koͤmen
chundent->kundent
chainer->kainer
chriechen->kriechen
cheusch->keusch
charfreitag->karfreitag
chinder->kinder
chunste->kunste
chriechischen->kriechischen
chüniges->küniges
christus->kristus
handen->henden
fasten->festen
langer->lenger
haizzet->heizzet
tailen->teilen
rainen->reinen
zaichen->zeichen
haiden->heiden
waschen->weschen
rainig->reinig
rainigen->reinigen
maisterschefte->meisterschefte
haizzen->heizzen
machten->mechten
waynen->weynen
kainen->keinen
haimlich->heimlich
kaiser->keiser
maynung->meynung
baider->beider
nahent->nehent
hailig->heilig
hailigen->heiligen
sahent->sehent
hailiger->heiliger
garten->gerten
haisset->heisset
kaines->keines
wainet->weinet
hailige̅->heilige̅
haissent->heissent
maisterschaft->meisterschaft
mainung->meinung
vatter->vetter
laiter->leiter
haissen->heissen
kament->kement
zaigen->zeigen
mainu̅g->meinu̅g
falschen->felschen
wachset->wechset
markten->merkten
kaisers->keisers
namlich->nemlich
mainet->meinet
maisterliche->meisterliche
manlich->menlich
haistu->heistu
darvon->dervon
maistern->meistern
tailes->teiles
wainen->weinen
naigen->neigen
kainez->keinez
gaiste->geiste
salter->selter
fallen->fellen
rainet->reinet
naiget->neiget
laider->leider
sagent->segent
saligen->seligen
maynen->meynen
layder->leyder
hafftet->hefftet
massen->messen
hassen->hessen
manges->menges
saltere->seltere
sagene->segene
vastene->vestene
warlichen->werlichen
mangen->mengen
hailen->heilen
satten->setten
wallen->wellen
ware̅t->were̅t
hattent->hettent
baiden->beiden
farbet->ferbet
darzuͦ->derzuͦ
rasten->resten
ratten->retten
warmen->wermen
heiligs->heiliges
getailn->getailen
gevarn->gevaren
verdient->verdienet
stirbt->stirbet
veraint->verainet
bedewtt->bedewtet
verdienn->verdienen
lebens->lebenes
gevestent->gevestenet
vaters->vateres
gemert->gemeret
gezirt->geziret
gelegt->geleget
bedeutt->bedeutet
gefragt->gefraget
sundern->sunderen
person->persoen
versten->versteen
innern->inneren
gesalbt->gesalbet
handelt->handelet
gehabt->gehabet
geordent->geordenet
geheiligt->geheiliget
wescht->weschet
erwelt->erwelet
klains->klaines
bringt->bringet
haisst->haisset
vertrawn->vertrawen
erfarn->erfaren
liechts->liechtes
kindern->kinderen
versiglt->versiglet
nahent->nahenet
nachts->nachtes
erhort->erhoret
bedacht->bedachet
bekert->bekeret
besten->besteen
gehebt->gehebet
gerett->geretet
gefürt->gefüret
erklert->erkleret
erkennt->erkennet
wirfft->wirffet
begreifft->begreiffet
erbern->erberen
gemerckt->gemercket
verkern->verkeren
gewist->gewiset
gelebt->gelebet
anfaht->anfahet
besorgt->besorget
vermischt->vermischet
begert->begeret
gepurt->gepuret
twingt->twinget
wandeln->wandelen
geschiht->geschihet
offent->offenet
erlangt->erlanget
bewert->beweret
offenbarn->offenbaren
murmelt->murmelet
erhebt->erhebet
geschafft->geschaffet
hilfft->hilffet
gepeynigt->gepeyniget
bewarn->bewaren
geschen->gescheen
bekern->bekeren
gebezzert->gebezzeret
gesundert->gesunderet
bezzern->bezzeren
geminnert->geminneret
geteilt->geteilet
welchs->welches
cleidern->cleideren
gedruckt->gedrucket
wechst->wechset
vinstern->vinsteren
gelacht->gelachet
heischt->heischet
volendt->volendet
alders->alderes
geendt->geendet
gewert->geweret
gehyndert->gehynderet
geneigt->geneiget
gehenckt->gehencket
erzaigt->erzaiget
beginnt->beginnet
gesterkt->gesterket
gewendt->gewendet
verzert->verzeret
segenn->segenen
geschikchet->geschikcht
gemerkchet->gemerkcht
gesaget->gesagt
volfueren->volfuern
gelobet->gelobt
erweret->erwert
treibet->treibt
geübet->geübt
genennet->genennt
begeret->begert
begeren->begern
getötet->getött
wunderen->wundern
geporen->geporn
veteren->vetern
gesuͦchet->gesuͦcht
gezaiget->gezaigt
erfulet->erfult
erlediget->erledigt
gevaren->gevarn
bekeren->bekern
bitteren->bittern
schiffes->schiffs
zerstoͤret->zerstoͤrt
geseczet->geseczt
verzwifelet->verzwifelt
offenbaren->offenbarn
regiren->regirn
geendet->geendt
gefüget->gefügt
bestellet->bestellt
entzündet->entzündt
würdet->würdt
lauffet->laufft
beruret->berurt
wirffet->wirfft
gefüret->gefürt
lebenes->lebens
wechset->wechst
vleisches->vleischs
vateres->vaters
suͦchet->suͦcht
gelernet->gelernt
gemanet->gemant
beginnet->beginnt
besteen->besten
gekeret->gekert
cameren->camern
erberen->erbern
kameren->kamern
kynderen->kyndern
bannyer->bannyr
krieges->kriegs
gekempet->gekempt
cleyderen->cleydern
gescheen->geschen
wasseren->wassern
sunderen->sundern
etliches->etlichs
iacobes->iacobs
romeren->romern
begabet->begabt
enberen->enbern
geschihet->geschiht
gelachet->gelacht
gehebet->gehebt
gehabet->gehabt
sunderes->sunders
glichet->glicht
bruderen->brudern
osterreich->osterrich
sicherleich->sicherlich
himelreich->himelrich
guͤttleich->guͤttlich
etleich->etlich
geleich->gelich
begierig->begirig
gewonleich->gewonlich
alleweg->allweg
schrieren->schriren
rechtleich->rechtlich
spiegel->spigel
berueret->beruret
wesenleich->wesenlich
igleich->iglich
semleich->semlich
ygleich->yglich
ordenleich->ordenlich
offenleich->offenlich
bruͤeder->bruͤder
fuͤeren->fuͤren
toͤrleich->toͤrlich
brueder->bruder
froͤleich->froͤlich
truegen->trugen
vlreich->vlrich
sluegen->slugen
warteten->wartten
fliehen->flihen
gezieret->geziret
geleben->gelben
gedienet->gedinet
marterer->martrer
begirleich->begirlich
fliezze->flizze
fliegen->fligen
erloeste->erloste
verleust->verlust
heilegen->heilgen
manegen->mangen
niregen->nirgen
scheine->schine
droegen->drogen
erberen->erbren
burgeren->burgren
verloeren->verloren
geleden->gelden
handelen->handlen
spraeche->sprache
staende->stande
begreiff->begriff
gebeüt->gebüt
regierer->regirer
erneste->ernste
macheten->machten
schreiben->schriben
ettleiche->ettliche
genuegsam->genugsam
treiben->triben
beleiben->beliben
siechst->sichst
guettet->guttet
ziechen->zichen
geessen->gessen
geweicht->gewicht
schreibet->schribet
schreiber->schriber
guetten->gutten
villeicht->villicht
geleiche->geliche
treibet->tribet
viellen->villen
muezzen->muzzen
scheinen->schinen
niemant->nimant
wierdig->wirdig
fuëren->füren
suesser->susser
vierden->virden
fuessen->fussen
verdriessen->verdrissen
zehenden->zehnden
erleiden->erliden
dienete->dinete
fleizze->flizze
geschreifft->geschrifft
igelich->iglich
ettelich->ettlich
schedelich->schedlich
sweigen->swigen
bleibet->blibet
liechte->lichte
sweygen->swygen
bleyben->blyben
bedeutet->bedutet
enseulde->ensulde
argelist->arglist
noement->noment
leenden->lenden
vyengen->vyngen
lieffen->liffen
spraechen->sprachen
suessen->sussen
schiessen->schissen
geboerten->geborten
hienach->hinach
zweifel->zwifel
kriechen->krichen
vngeleiche->vngeliche
dienene->dinene
menschleichen->menschlichen
goͤttleicher->goͤttlicher
goͤttleichen->goͤttlichen
götleicher->götlicher
geistleicher->geistlicher
beleibe->bleibe
wunderleichen->wunderlichen
igleichen->iglichen
naturleicher->naturlicher
ritterleichen->ritterlichen
ygleichen->yglichen
igleichem->iglichem
zeitten->zitten
gleicher->glicher
ettleichen->ettlichen
weyroch->wyroch
bedeücht->bedücht
beliben->bliben
meisten->misten
guetlich->gutlich
gleichen->glichen
ierrung->irrung
weitten->witten
vierczig->virczig
dienstes->dinstes
enpheingen->enphingen
yeglich->yglich
angenomen->angnomen
leüten->lüten
feinden->finden
gereden->greden
geleicher->gelicher
reichen->richen
gelaubt->glaubt
genedig->gnedig
dreissig->drissig
willigleichen->williglichen
ygeliche->ygliche
hoffenunge->hoffnunge
pelegen->plegen
geloube->gloube
seulden->sulden
roemeren->romeren
eessich->essich
veirden->virden
bereite->breite
gelucke->glucke
lieplich->liplich
leichte->lichte
bericht->bricht
geleiches->geliches
heilig->hailig
fleisch->flaisch
messen->massen
wellen->wallen
nemmen->nammen
vetter->vatter
lenger->langer
henden->handen
gessen->gassen
mengen->mangen
menger->manger
welden->walden
wennan->wannan
dennan->dannan
besessen->besassen
gendes->gandes
gedencke->gedancke
mercke->marcke
gedechte->gedachte
geedelt->geadelt
segent->sagent
stercke->starcke
vetern->vatern
petrum->patrum
gerten->garten
senten->santen
lenden->landen
weinen->wainen
keinen->kainen
bereiten->beraiten
erzeigen->erzaigen
gescheiden->geschaiden
meinet->mainet
lesset->lasset
schleffen->schlaffen
wechen->wachen
beumen->baumen
wermen->warmen
hecken->hacken
fellen->fallen
heiden->haiden
gengen->gangen
sterker->starker
erkeltet->erkaltet
teilen->tailen
gemeinem->gemainem
retend->ratend
gesetzet->gesatzet
spennen->spannen
weppen->wappen
dervon->darvon
gehabt->gehebt
etwann->etwenn
wirdichait->wirdicheit
heilichait->heilicheit
menschait->menscheit
unrain->unrein
gewonhait->gewonheit
gemain->gemein
hoͤrast->hoͤrest
gehaft->geheft
geschach->geschech
gesagt->gesegt
vnderschaid->vnderscheid
schraib->schreib
gelegenhait->gelegenheit
erkant->erkent
belaib->beleib
gebant->gebent
vergass->vergess
gesunthait->gesuntheit
gegenwertigkait->gegenwertigkeit
torhait->torheit
sicherhait->sicherheit
kranckhait->kranckheit
gestalt->gestelt
gewand->gewend
widertail->widerteil
schaff->scheff
kluͦghait->kluͦgheit
schicklichait->schicklicheit
unwarhait->unwarheit
cristenhait->cristenheit
kranchait->krancheit
vrtail->vrteil
erschain->erschein
selikait->selikeit
kinthait->kintheit
vnwissenhait->vnwissenheit
weißhait->weißheit
worhait->worheit
clarhait->clarheit
scharf->scherf
gelart->gelert
gekart->gekert
geschait->gescheit
niemans->niemens
getrang->getreng
miltikait->miltikeit
verzart->verzert
bosshait->bossheit
beschahe->beschehe
sprache->spraeche
ettwas->ettewas
wartten->warteten
dienten->dieneten
geriten->gerieten
erpiten->erpieten
frewdenrich->frewdenreich
redten->redeten
verloren->verloeren
geordnet->geordenet
merten->mereten
gelich->geleich
begirlich->begirleich
ertrich->ertreich
sicherlich->sicherleich
andre̅->andere̅
anbetten->anbeteten
bilgrin->bilgerin
yetlich->yetleich
gewist->geweist
regiren->regieren
gezilt->gezeilt
gebüt->gebeüt
fremden->fremeden
heilgen->heilegen
spigel->spiegel
erlosen->erloesen
gewirt->geweirt
verzihen->verziehen
zaubrer->zauberer
flihen->fliehen
ordiniren->ordinieren
innren->inneren
verdinet->verdienet
ungelich->ungeleich
claren->claeren
ernste->erneste
buwden->buweden
warnde->warende
gelych->geleych
unsren->unseren
eignen->eigenen
ordnen->ordenen
sundren->sunderen
handlen->handelen
schefflin->scheffelin
silbrin->silberin
glider->glieder
strite->streite
gedenken->gedencken
beschehen->beschechen
artikel->artickel
trinken->trincken
fleken->flecken
werken->wercken
gemahel->gemachel
angesehen->angesechen
ertrunken->ertruncken
smakte->smackte
trunken->truncken
wurken->wurcken
gerehte->gerechte
knehte->knechte
geschihte->geschichte
geslehte->geslechte
moͤhte->moͤchte
verlihen->verlichen
trucken->truccken
starker->starcker
gemerket->gemercket
ganzen->ganczen
krenken->krencken
drinken->drincken
sterket->stercket
punten->puncten
gedrunken->gedruncken
ganze̅->gancze̅
welhes->welches
gerihte->gerichte
sterker->stercker
liehte->liechte
fruhte->fruchte
gemahte->gemachte
welhen->welchen
solhen->solchen
bedenken->bedencken
drüken->drücken
welhem->welchem
gerehen->gerechen
zwenzig->zwenczig
gesihte->gesichte
anegesihte->anegesichte
vnrehte->vnrechte
forhte->forchte
gedohte->gedochte
gedahte->gedachte
wirken->wircken